START 0 0 EXIT 9 9
0000001010
0110100010
0100111000
0000000110
1110101000
1000101100
1011100001
1010101101
1000001001
1111111100