START 0 0 EXIT 39 39
0101000001000100000000000000000100000001
0101010101010101011101110101110111110111
0100010101010001000100010100010000010001
0111010111011101110111010111011111011101
0001010000010001000101010001000001010001
1101111101111101011101011101111101010101
0100000101000001010000010000010101000101
0111110101110101010111111111010101111101
0100010100000101010000000101000100000101
0101010111111111011111110101011111010101
0101000100000000010000010100010000010101
0101111101111101110111010101110111010101
0100010001000000000101010100010001010101
0111011101110111111101010111011101010111
0000000001000100010000010001000101010001
0111111111011101110111111101011101011101
0000000000010001000100010001010001010001
0111011111110111011101110111010111010101
0100010000000000000001000100010100010101
0101110111110111110111011110110101110101
0101000100010100010100010000000101000101
0101011101011101011101110101111101011101
0101000101000001000001010100010100010101
0101111101111111111111010111010111110101
0100000101000100000001000100010001000101
0111110101010101011101110101110101010101
0100010100010101000100010101000101010001
0111010111110101110111010101111101011111
0001010100000100010101010100000101000101
1101010101111111010101011110110101110101
0100010001000100010101000000000100010101
0111011111010101110101111011111101010101
0100010000010001000100000100000001010101
0101111110111111011111110101111101010101
0101000100000001010000000100010101010101
0101010101111101010101111111010101110101
0100010101000101010100010000010101000101
0111110101010101010111010111110101011101
0000000001010000010001000000000100000000
1111111111111111111111111111111111111100