START 0 0 EXIT 49 49
00000001000000000100000001000100010000000100000001
11111101111101110111110111010101010101101101110111
01000100000001010000010000010101000100000101010001
01010111111111011111011101110101111111110101011101
00010000010000000001000000010001000000010000000101
01111101110111011101111011010111011101111111111101
00000100010100010100000001010100000100000001000001
11111111010101010111110111010111111101011101011101
00000000010001010100000100010000000101010001010001
01111111011111010101111101111111110101011111011101
00010001010100010100000001000001010101010001000101
11010111010101110111111111011101000111010101110111
00010000000100000100010001000100010100010100010001
01111111111111110101110101010111010101110111011101
01000000000000000100010100010101010001000101000001
01011111111110111111010111110101010111011101111101
01010001000001000001000100000100010100010000000001
01010101011101110101111101111101110101110111111011
01000101010100000100000101000101000101000100000001
01111101010111111111110101010111011101111101111101
00000101010001000001000100010001000100000001000001
11110101010101011101011111011101110111111111011111
00010100010100010001010000000001010100010100010001
01010111110111110101011101111101010101010101110101
01000001000100010101000100010001010101000100000101
01111011011111010111110111010111010101111111111101
01000000010001010000000100010000010100010000000001
01011111110101011111111101111101110111010111111101
01000000010100010000010001000101000100010100000101
11111111010111010111010101010111011101010111010101
00000001010001010101010100010001010001010001010001
01111111011101010101010111111101010111011101111101
01000000010001000100010000000000000101000100000101
01011111110111111101111101111111111101110111110101
01000100000100000100010001000001000001000100010101
01110101110111110111010111011101011101011101010101
00000101000000010001010001010001000100000001010101
01111101011111010111010111010111110111111111110101
00010001000001010000010100010001000100000000010101
11010111011111011111110101111101011101111111010111
00010100010001000000000100010101010101000001010001
01110101110101111011011111010101010101011101010101
01000001000100000001010001010001000101000101010101
01110111011101111101010101010111111101110111011101
00010100010001000001000101010000000100010000010001
11010101110101011111111111011111110111010111110101
00010101000101010001000000010001000100010000000101
01111101011111010101011111110111011101111111111101
00000001000000000100010000000000000001000000000000
11111111111111111111111111111111111111111111111100