START 0 0 EXIT 79 79
01000000010000000100000000000000000101000000000000000000000101000000010000000001
01110111011111010111110111111011110101011101110101111111010101011111010111011111
00010001000000010100000100000000010100010001000100010001010001010100010101010001
11011101111111110101111101111111010101110111011111011101011111010101010101010101
01010001000000010001000100010001000101000100000001000001000100010101010001010101
01010111111111011111010111011101111111011111110111111101110101110101111101010101
01000100000000010001010000010000000001010000010100000001000100000100010001000101
01111101011111011101011111110111111101010111010101111111011111110111010111111101
00000101000100000001000000010100000101010101010100000001000001000101000100010101
11010111110111111111111111010101111101010101010111111101110111011101111101010101
00010000010100000001000000010101000001000101010100000001010001010000000101010101
01111111010101111101011111110101011111110101010101111111011101011101010101010101
00010001000100010100010000000100010000010001010100000100000101000101010101000101
01010101110111010111110111111101111101010111011111110101011101110111010101111101
01000101000001010000000001000100000001010100010000000101010001010000010101000001
01111101111111011101111101011111111111010101110111111111010101011111110101011101
00000100000001000101000001000001000001010100000100000001010100010000010101000101
01110111111101110111011111110101011101011111110111011101010111110101010101110111
01010100000100010000010000000101010101000000010000010000010001000101010001010001
01010101110111011111110111111101010101111111011101111111110101011101111101011101
01000101000000010000000100010000010001000100010101000000010100010101000000010001
01110101111011011101110101011111110111011101110101011111010111110101011111110101
00010001000100000100010101000001000000010001000001010001010000000100010000000101
01011111010111110111010101111101111111110111111111011101011111111111110111111101
01000000010000010000010100000101000000000100000000010001000000010000000100000001
01111101111111011101111111110101011111111101111011110111111111010111111111111101
01000000000001000101000000010101010000000001000000000000000001010000000000000101
01011111110101110111011101110101010111111111011111111111011111010111111111110111
01010000000100010001010100000101010000010001000001000001000001010100000000010001
01110111110111110101010111111101011111010101111101011111111101010101111111011101
00010100000100010101010000010001010000010100010001000001000100010100010001000101
11010111111101011101011111010101010111111101010111110101010111110111010101110101
01010000000101000001000001010101010000000101010000010101010001000100010100000101
01011111110101111101111101010111011111010101111111010101010111011101110111111101
01010000000100000100000100010000010001010100000001010100010000010001000100010001
01010111111101110101111111011111110101110111011101011111011111110111011101011101
00010000000001000101000000010000000100010001000101000001010000010001000001000001
01111111111101011111011111110101111111010101110101111101011101111101110111111101
01000000000101010000010000010101000100010101000100000101000001000100000100010001
01011111110101010111110111010101010101111101011111110101111111010111110111010111
01000100010101000100000101010101010001000001010001000100000100010000000100010001
01110101110101111111110101010101011111110111011101011111110101111111111101111101
01000101000100000000000100010101000100000100000100010000010100000001000100000101
01011101011101111101111101111101110101111111110111110111010101111101010101110101
00010001010001000000000100000101000001000000000100000101010100000101010100010001
11111101010111010111111111110101111111011111011101111101010111110101010111011111
00000001010100010100000000010100000001010001010001000001010001000001010001000001
01111111010111110101111101110101111101011101010111111101011101011111111101111101
00000000010000010100000101000100010001000100010000000001000100010000000001000101
01111111011111010111110101011111010111110111111111111101110111110111011111010101
01000100000001010001010100010001010001000100000100000100010000010101000100010001
01010101011101010101010111110101111101011101110101011111011101010101110101111111
00010101010101010100010001000100000001000001010001000000010101010000010001000001
01110101010101010111111101010111111111011111011111111111110101110111110111110101
00010101010100010100010001010000010000000000000000000000000100000100010100000101
01010101010111110101010111011111011111111101111101111111111111111101010111011111
01000101010000000001000100010001000001000100010001000001000000000001010000010001
01111111011101111101111101111101111101010101011111011101011111111101011111010101
00000001000101000000000000000000010100010001000000010101010001000101000001010101
11111101010101110111111111111111010111111111111111110101010101010111111101110101
00000101010100010100000000000101010000010000000100000100000101010000000100000101
01010101110111010101111111110101010111010111110111010111110111011111010111110101
01010101000100010101010000010101000100010101000000010100010100010001000000010101
01010101011111011101010101110101111101110101011111111101011101010101111111010101
01010101000001000001000100010100010001000100010100000001000101010100010001010101
01011101011101111111011111010111010111011101110101111111110101110111011101011101
01000101000101000001010100010001000100010001000101000000000101000001000101000101
11110101111101010111010101111101011101110111010101110111111101011111110101110101
00000100000101010001000100000001000101000000010100010001000000000100000100000001
01110111110101111101110111111111110101111111110111011101111111111101111101111111
01000000010001000000010001000001000001000000010001010100010000000100000101000001
01111111011111011111011101011101011111011111011111010111010111110101110111011101
00000100000000000100000101010101000100010001010001010001000101000100010000000101
11110101111111110101111101010101110101110101010101011101111101011111110111111101
00000100000101000100010001010000010101000100010100010000000100010000010000010001
01110111110101011111110111011111011101011110110111110111110101110111011011110111
00010100010001000000010100000101000001010001000000000001000100010100010000010001
01011101011101111111010111110101111111010101110101111101111111010101110111011101
01000001000000000001000000000100000000000100000100000100000000000100000100000000
11111111111111111111111111111111111111111111111111111111111111111111111111111100
