START 0 0 EXIT 19 19
01000000010001000001
01011101010101110111
00010101000100010001
01010101111111011101
01000101000000000101
01110101110111110101
00010100010100010001
11011111010101011101
01000100010101010001
01110101110101010111
00010001000001010001
01010101101111011101
01010100000100000101
01010111110101011101
01010100000101010001
01110101111101110111
00010100010100000101
01010111010101111101
01000000010000000000
11111111111111111100