START 0 0 EXIT 29 29
010000000101000000010000010001
011111010101010111010111011101
000000010100010001000101010001
110111110111111101111101010111
000000010000000101000001010001
010111011101110101011111011101
010100000101000101000100010001
010111110101011101010101110111
010001010101000101010101000001
011101010101110101010101011101
000101000000010001010101000101
111101011110111111010101110101
000101010000000000010101000101
010101110111011111010101011101
010101000100010000010101010001
010101011101110111110101110101
010001000100010001000101000101
011111010111011101011101011101
000000000101010000010001010001
011111111101011110110111011101
000001000001000100000100000101
111101011111110101111101110101
000000010000000101000101000101
011111110111110101010111011101
010000010100000100010100010101
110111010101111111110101110101
000100000100000100010001000001
011111111111111101011111011111
000000000000000001000000000000
111111111111111111111111111100
